OOOOOOOOOO
O O    O O
O . OO   O
O O O    O
O O OO O.O
O O O    U
O OOOOOO.O
O O      O
O O O OOOO
O . O    O
OOOOOOOOOO
